┌──┬──┐         ┌──┬──┐
│  │               │  │
├──┤               ├──┤
│  │               │  │
│  │               │  │
│  │               │  │
├──┤               ├──┤
│  │       X       │  │
│  │               │  │
│  │               │  │
├──┤               ├──┤
│  │    ###########│  │
│  │   # ►/──\◄ ###│  │
│  │  ##─│BOSS│─## │  │
├──┤ ### ►\──/◄ #  ├──┤
│  │############   │  │
│  ├───────────────┤  │
│  │               │  │
└──┴───────────────┴──┘