┌───────┬───────────┬────────────┬──────┬──┐
│       │           │            │      │  >
│       │  ┌────    │   ┌─────   │   ───┤  >
│   │   │  │        │   │        │      │  │
│   │      │   ─────┘   │   ─────┼────  │  │
│   │      │            │        │      │  │
│   └──────┼───┬────────┘   ──┐      │  │  │
│          │ #                └┬─────┘  │  │
├───────   │       ────────┐   │           │
│          │   │           │   │    ┌───┐  │
├──────────┘   ├─────────  │   │    │   │  │
│              │           │   │    │   │  │
│    ──────────┤  ┌────────┘        │   │  │
│              │  │                 │   │  │
├───────────   │  ├───────┬──┬─────┬┘   │  │
│              │  │       │  │     │    │  │
│  ┌───┬───────┤      │   │  │  │  │    └──┤
│  │   │       ├──────┘   │  │  │  │       │
│      │       │          │  │  │  │  │    │
│      │   │   │   ───┬───┘  │  │  │  │  ──┤
│  │   │   │   │      │         │  │  │    │
│  │       │          ├─────────┘     ├──  │
└──┴───────┴──────────┴───────────────┴────┘